rain@combine@RelatedTo	false
weigh@do@RelatedTo	false
shop@walk@RelatedTo	false
put@add@RelatedTo	false
need@want@RelatedTo	true
carry@lose@RelatedTo	false
increase@harvest@RelatedTo	false
find@buy@RelatedTo	false
cover@do@RelatedTo	false
pay@plan@RelatedTo	false
combine@rain@RelatedTo	false
finish@get@RelatedTo	false
eat@produce@RelatedTo	false
spend@receive@RelatedTo	false
buy@eat@RelatedTo	false
serve@make@RelatedTo	false
give@find@RelatedTo	false
tear@buy@RelatedTo	false
gather@sell@RelatedTo	false
fill@pour@RelatedTo	true
do@cover@RelatedTo	false
need@require@RelatedTo	true
snow@combine@RelatedTo	false
call@need@RelatedTo	false
lose@carry@RelatedTo	false
find@give@RelatedTo	false
pick@give@RelatedTo	false
do@own@RelatedTo	false
purchase@own@RelatedTo	false
get@eat@RelatedTo	false
make@use@RelatedTo	false
break@find@RelatedTo	false
bear@immigrate@RelatedTo	false
go@spend@RelatedTo	false
go@attend@RelatedTo	true
pay@spend@RelatedTo	true
eat@buy@RelatedTo	false
load@fill@RelatedTo	true
crack@find@RelatedTo	false
do@travel@RelatedTo	true
run@walk@RelatedTo	true
plan@attend@RelatedTo	false
pave@use@RelatedTo	false
play@win@RelatedTo	false
harvest@do@RelatedTo	false
remain@spill@RelatedTo	false
spend@go@RelatedTo	false
buy@spend@RelatedTo	true
walk@run@RelatedTo	true
get@finish@RelatedTo	false
rain@do@RelatedTo	false
get@spend@RelatedTo	false
put@call@RelatedTo	true
call@put@RelatedTo	false
plan@go@RelatedTo	false
miss@go@RelatedTo	false
sell@gather@RelatedTo	false
do@hike@RelatedTo	false
go@plan@RelatedTo	false
need@serve@RelatedTo	false
contain@spill@RelatedTo	false
fill@load@RelatedTo	true
fill@hold@RelatedTo	false
leave@cover@RelatedTo	false
walk@shop@RelatedTo	false
list@call@RelatedTo	false
pour@fill@RelatedTo	true
serve@need@RelatedTo	false
use@pave@RelatedTo	false
record@do@RelatedTo	false
want@spend@RelatedTo	false
ride@walk@RelatedTo	false
remain@fill@RelatedTo	false
play@miss@RelatedTo	false
do@harvest@RelatedTo	false
fill@remain@RelatedTo	false
make@serve@RelatedTo	false
add@put@RelatedTo	true
spend@want@RelatedTo	false
put@want@RelatedTo	false
sprint@take@RelatedTo	false
buy@tear@RelatedTo	false
eat@get@RelatedTo	false
do@weigh@RelatedTo	false
produce@eat@RelatedTo	false
start@sow@RelatedTo	false
buy@find@RelatedTo	false
do@eat@RelatedTo	false
go@miss@RelatedTo	false
own@buy@RelatedTo	true
combine@snow@RelatedTo	false
pick@weigh@RelatedTo	false
eat@do@RelatedTo	false
grow@eat@RelatedTo	false
add@contain@RelatedTo	false
sprint@do@RelatedTo	false
play@go@RelatedTo	false
find@crack@RelatedTo	false
immigrate@bear@RelatedTo	false
spill@contain@RelatedTo	false
walk@ride@RelatedTo	false
spend@purchase@RelatedTo	false
harvest@increase@RelatedTo	false
pour@add@RelatedTo	false
attend@go@RelatedTo	false
pay@go@RelatedTo	false
need@call@RelatedTo	false
spend@pay@RelatedTo	false
cover@leave@RelatedTo	false
use@make@RelatedTo	false
do@use@RelatedTo	false
call@list@RelatedTo	false
buy@own@RelatedTo	false
win@play@RelatedTo	false
go@pay@RelatedTo	false
add@pour@RelatedTo	false
go@play@RelatedTo	false
spend@buy@RelatedTo	false
bear@begin@RelatedTo	false
miss@play@RelatedTo	false
eat@grow@RelatedTo	false
pour@serve@RelatedTo	true
hike@do@RelatedTo	false
spill@buy@RelatedTo	false
do@order@RelatedTo	false
can@result@RelatedTo	false
find@break@RelatedTo	false
do@sprint@RelatedTo	false
get@buy@RelatedTo	true
hold@fill@RelatedTo	false
do@rain@RelatedTo	false
own@do@RelatedTo	false
buy@spill@RelatedTo	false
contain@add@RelatedTo	false
buy@get@RelatedTo	true
sow@start@RelatedTo	false
receive@spend@RelatedTo	false
do@record@RelatedTo	false
result@can@RelatedTo	false
spend@get@RelatedTo	false
purchase@spend@RelatedTo	false
use@do@RelatedTo	false
give@pick@RelatedTo	false
take@sprint@RelatedTo	false
eat@own@RelatedTo	false
own@eat@RelatedTo	false
weigh@pick@RelatedTo	false
attend@plan@RelatedTo	false
want@put@RelatedTo	false
spill@remain@RelatedTo	false
plan@pay@RelatedTo	false
own@purchase@RelatedTo	true
begin@bear@RelatedTo	false
order@do@RelatedTo	false
